111111111111111
100000010000001
100E0P0C0000C01
100000000000001
1001000000C0001
100100000000001
100111000000001
100000000000001
100C00000000001
100001000000001
111111111111111