11111111111111111111
1000000000cd0000000001
100000000P0000000001
1000000C00000000C001
10000000000000000001
10000000000000000001
10000C00000000000001
10000000000000000001
10000000000000000001
100C00000000000E0001
10000000000000000001
11111111111111111111