1111111111111111111111111111
1000101010101000000000000001
100C1010000000C0000000000001
10C1010C00CCCCC0C00000000001
100C000C00000000000P00000001
1000C0C000000000000000000001
10001C0000000000000000000001
1000011000000011111000000001
1000010100001000000000000001
100C01010000100E000000000001
1000000000001000000000000001
10CC101CC00000C0000000000001
1C00CCC00C000000000000000001
1C0000000C000000000000000001
10C00000C0000000000000000001
100C000C00000000000000000001
1000C11000000011111000000001
1000010100001000000000000001
100C010100001000000000000001
1000000000001000000000000001
1111111111111111111111111111