11111111111111111111
10000000010001000001
10111001000001000001
101E100C00000100C001
10000000000000000001
10010001000001000111
10010C01000000000001
10011111000000000001
10000000000000000001
100C00000000000P0001
10000000000000000011
11111111111111111111