11111111111111111111
10001010101010000001
100C1010000000C00001
10C1010C00CCCCC0C001
100C000C000000000001
1000C0C0000000000001
10001C00000000000001
10000110000000111111
10000101000010000001
100C01010000100E0001
10000000000010000001
10CC101CCP0000C00001
1C00CCC00C0000000001
1C0000000C0000000001
10C00000C00000000001
100C000C000000000001
1000C110000000111111
10000101000010000001
100C0101000010000001
10000000000010000001
11111111111111111111