111111111111111
100000010000001
1000000C0000C01
100000000000001
1001000000C0001
100100000000001
100111000000001
100000000000001
100C00000000P01
100001000000001
111111111111111